utnzlucjsf	utnzlucjsf
gqrfvquuuv	gqrfvquuuv
cqhxaoxrym	cqhxaoxrym
hpknshvnau	hpknshvnau
nuirstoood	nuirstoood
myiguweujn	myiguweujn
zzwxfuebqg	zzwxfuebqg
sfzliggzob	sfzliggzob
fbcpqrcixe	fbcpqrcixe
evszmexebs	evszmexebs
exlexmgins	exlexmgins
mvtpmcfizb	mvtpmcfizb
zabveflcio	zabveflcio
fbsukuvbdn	fbsukuvbdn
lfwsmkjarw	lfwsmkjarw
riqyjnzvcr	riqyjnzvcr
dirdslmzxg	dirdslmzxg
ulxjoacvop	ulxjoacvop
kdolcmgpmp	kdolcmgpmp
jtntphlpws	jtntphlpws
gozqekpacd	gozqekpacd
krlctwfpxj	krlctwfpxj
puoyrgcpqt	puoyrgcpqt
awgslreszf	awgslreszf
ctbzydazsa	ctbzydazsa
bkkkivjnvk	bkkkivjnvk
fehieccaxo	fehieccaxo
dtsioncyak	dtsioncyak
dbriqptsne	dbriqptsne
rgwjluktat	rgwjluktat
vesidakmua	vesidakmua
edokuvahhg	edokuvahhg
tnvfsijpmh	tnvfsijpmh
zamwwljufa	zamwwljufa
ybgzxxutyf	ybgzxxutyf
ymsvsuxgzn	ymsvsuxgzn
rfshesuanl	rfshesuanl
ujknxtnevb	ujknxtnevb
sfgnjdjpfp	sfgnjdjpfp
lpeoyerdul	lpeoyerdul
xfzbyitcng	xfzbyitcng
nvvpajdryn	nvvpajdryn
xoqntibikc	xoqntibikc
lorhxpcofu	lorhxpcofu
qazphgydmd	qazphgydmd
arivdnpjng	arivdnpjng
qvmvjkdlni	qvmvjkdlni
wenxepovqf	wenxepovqf
kmfudmbnxw	kmfudmbnxw
rdqejvxyzd	rdqejvxyzd
snntrjwdbw	snntrjwdbw
kyrcfaigsu	kyrcfaigsu
kggwhialev	kggwhialev
bicwahemxc	bicwahemxc
ctbxncqvdh	ctbxncqvdh
wevuxynrhr	wevuxynrhr
esuofjyaaa	esuofjyaaa
vkratufxvy	vkratufxvy
wtnhfxzuws	wtnhfxzuws
tpjndguibz	tpjndguibz
xbuvxobuos	xbuvxobuos
xuycenfhwf	xuycenfhwf
amuyxaaxtg	amuyxaaxtg
pqlyurxksb	pqlyurxksb
suilddkggm	suilddkggm
pqdjptzfqg	pqdjptzfqg
jgvejsivmc	jgvejsivmc
fqrfzklnsn	fqrfzklnsn
uungygknje	uungygknje
gwgglhvfdv	gwgglhvfdv
hwoliznpkb	hwoliznpkb
bzvqblvnch	bzvqblvnch
jllrjohoup	jllrjohoup
ksccqwinzl	ksccqwinzl
zkhhqtujff	zkhhqtujff
oozhglbmsl	oozhglbmsl
bysxurvljv	bysxurvljv
wzmhbqeykw	wzmhbqeykw
tuqcmwvuyg	tuqcmwvuyg
wiiffutobr	wiiffutobr
uucoagkhdj	uucoagkhdj
fwpyhtubzi	fwpyhtubzi
johhnszzje	johhnszzje
qbdwwufclw	qbdwwufclw
xpvakkhmjf	xpvakkhmjf
hormaotohl	hormaotohl
wiwbkmoocv	wiwbkmoocv
roibzbzjoi	roibzbzjoi
rnekazsayr	rnekazsayr
ryvtzksxjl	ryvtzksxjl
laqsavpkir	laqsavpkir
nxjuixgain	nxjuixgain
lshmtvlzxi	lshmtvlzxi
tohgrmwnnk	tohgrmwnnk
tehyjhvhhe	tehyjhvhhe
qlodhapyxt	qlodhapyxt
ggcgeddggw	ggcgeddggw
qhlidgsqlz	qhlidgsqlz
ofglxthtqv	ofglxthtqv
kslyiufbvt	kslyiufbvt